90.
23_23_00_01_22_21_
10111111111111111111111
10001000000000000000101
10101011111010111010101
10101000001010101010101
10101111111010101010101
10100000000010101010001
10111111111010101011111
10000000000010101000001
11111111111110101111101
10000000000010000000101
10101111111011111111101
10100000001000000000001
10101111111111111111101
10101000001000000000001
10101011101111111111111
10101010101000001000001
10101010101011101011101
10101010101010101010101
10111010101010101010101
10000010101010101010101
10111110101010101010101
10000000100000100010001
11111111111111111111101