120.
23_29_01_00_21_28_
10111111111111111111111
10000000000010000000001
10111110111110111111101
10000010000010000010101
11101111111011111010101
10100010001000000010001
10101110101111111110111
10100000100000100010001
10111011111111101111101
10000000100000100000101
11101111101110111110101
10101000101010001010001
10101010101011101011101
10100010001000001010101
10111111101111111010101
10000000100010100010101
10111111111010101010101
10000000001010001000101
11111111101011101011101
10001000001010101010001
11101010111010101010111
10001010100010101000001
10111010101110101111101
10000010100010001000101
11111110111010111010111
10000010001010100010001
10111010101010101111101
10001000100010001000001
11111111111111111111101
