180.
31_31_00_15_31_21_
1111111111111110111111111111111
1010000000000000000010000000001
1010111111111110111010111110101
1010100000100000100010000010101
1010101110101111111011111010101
1000101000100000001010001010101
1011101011101111101110101010101
1000101010000000101000100010101
1110101011111111101011111110101
1010101000000000001000001010101
1010101111111011111111101010111
1000100000101010001000000010001
1011111010101010101011111111101
1010101010100010100000100000101
1010101010111110111111101110101
1000101010000000100000101000101
1111101011111111101110101011101
1000001010000000101000101000001
1011111010111110101011101111101
1010000010001000101000001000101
1011111111101011101111111010101
1010000000001000100010000010101
1010111111111110111010111110101
1010001000000010001010000010101
1011101011111011101010111011101
1000001010001000100010101000001
1111111010101010111110101111111
1010000010101010000010100000101
1010111110101011111110101110101
1000000000101000000000001000001
1111111111111111111110111111111