1111111111111111111111111111111111101111111
1000000000100010000000000000000000100000001
1111111110101010111111111011111111101111101
1000000010001000000000001000000000001000001
1011111110111111111111111111111111111111111
1010100000000000000000000000000000001000001
1010101011111111111111101111111111111010101
1010101000000000000000101000000000000010101
1010101011111111111110101011111111111110101
1010001010000000000010101010000000000000101
1011111010111111111010101010111111111111101
1000000010100000001010101010100000000000001
1111111110101111101010101010101111111011111
1000000000101000101010101010101000001010101
1011111110101010101010101010101011101010101
1010000010101010101010101010101010101010001
1010101011101010101010111010101010101010101
1010101000001010101010000010101010101010101
1010101111111010101011111110101010101110101
1010101000000010101000000000100000100000101
1010101011111110101011111110111111111111101
1010101010000010101010000010100010000000001
1010101010111010101010111010101010111111101
1010101010101010101010101010101010100000001
1010101010101010101010101010111010101111101
1010100010101010101010101010000010101000101
1010111110101010101110101011111110101010101
1010000000101010100000101000000000101010101
1011111111101010111111111110111111101010101
1000000000001010100010000010101000101010101
1011111111101010101010111010101010101010101
1010000000101010101010101010101010101010101
1010111110111010111010101010101010101010101
1010100010000010000010101010001010101010101
1110101111111111111110101010111010111010101
1000100000000010000010100000000010000010101
1011111111111010101010101111111111111110101
1010001000001010101010101000100000000000101
1010101011101010101010101010101111111111101
1010101010000010101010101010101000000000101
1010101011111110101010101110101111111110101
1000101000000000101000100000100000000000001
1110111111111111111111111111111111111111111